
NO ./textures/Texture_1.xpm
SO ./textures/Texture_2.xpm
WE ./textures/Texture_3.xpm
EA ./textures/Texture_4.xpm
DO ./textures/Texture_5.xpm

F 12,140,70
C 11, 211, 230


111111111
100000001
100000001
100000001
100000001
1000000011
110000011
1111CCC111
1000000011
10000000C
1000N00011
1000000011
1000000011
1111111111