
NO ./textures/Texture_1.xpm
SO ./textures/Texture_2.xpm
WE ./textures/Texture_3.xpm
EA ./textures/Texture_4.xpm


F 112,140,70
C 11, 211, 230



    11111111111111111111111111111111111111
    10000000000000000000000000000001
    111111111111111111100000000000011111
        100100000110000000000001111
1111111111111111111111100000011111111111111
111111111011000001110000000000001
10000000000000000000111111111111
1111011111111101110000001000111
11110111111  1111011101010010001
1100000011011001110000001000111
10000000000000000000000010001
1000000000000001101010010001
1100000111010101111101111000111111
11110111 1110101 101111010001   101
11111111 1111111 111111111111   111
