1111111111111111111111111111
11100000000000000000010011C1
1100000100000001011000000N01
10000C0000000001C11000000001
1000000001000001111111000001
10P000010000000000N00100N0N1
10000N0000000C0000000100NE11
1111111111111111111111111111